11111111111111111
10010000000C00001
10000100110010001
1P0011E00000C0001
11111111111111111
